0000000000000000000000000000
0000000000000000000000000000
0000000000000000000000000000
6111111111111561111111111115
2777777777777227777777772002
2761157611157227611157611502
2720027200027227200027200212
2741137411137437411137411372
277777cccccccc77777777s77772
2761157657611111157657611572
2841137227411561137227411372
2777777227777227777227777772
2861157241157227611327611572
2720027261137437411527200272
2720027227a7c7i7w77227200272
2720027227611111157227200272
2741137437200000027437411372
2777777777200000027777777772
4111157657200000027657611113
0000027227411111137227200000
000002s227777p77877227200000
0000027227611111157227200000
6111137437411561137437411115
2777778777777227777777777772
2761157611157227611157611572
2741527411137437411137261372
27772277777777s7777777227772
4157227657611111157657227613
6137437227411561137227437415
2777777227777227777227777772
2761111341157227611341111572
2741111111137437411111111372
27777777777777787777778777w2
4111111111111111111111111113
0000000000000000000000000000
0000000000000000000000000000