6111111111111111111111111115
2p77777877777777777777778772
4111111111111111111111111113
6111111111111111111111111115
27777777777777777777777787c2
4111111111111111111111111113